1111111111111
1P000T01000E1
1T0C000C00111
1111111111111