11111111111111111111
100CCCCCCTCCCCC00001
11P00000000000001111
11011111111111111111
11000000000000T00001
110000T00000T000CE11
11111111111111111111