11111111111111111
10T00000CP0000E01
1C0000C00000C0001
11111111111111111