11111111111111111111111111111111111111111111111111111111111111111111111111111111111111111111111111111111111111
1EP00CCC00000C100000000000000000000000000000000000000000000000000000000000000000000000000000000000000000000001
11111111111111111111111111111111111111111111111111111111111111111111111111111111111111111111111111111111111111